3  3  3  6  3  3  3  3  3  3  3  3  3  4  3  3  3  3  3  3
3  3  0  0  0  3  3  3  3  3  3  3  3  0  0  0  0  0  0  3
3 11  0  0  0  1  0  0  0  0  0  0  3  0  3  3  3  9  0  3
3  3  0  0  0  3  3  3  3  3  3  0  3  7  7  7  3  0  0  3
3  3  3  0  3  3  7  7  3  0  0  0  3  7  7  7  3  0  9  3
3  0  3  0  3  7  7  7  3  3  3  3  3  7  7  7  3  0  0  3
3  0  3  0  3  7  7  7  7  7  7  8  7  7  7  7  3  9  0  3
3  0  3  0  3  7  7  7  7  7  7  7  7  7  7  7  3  0  0  3
3  0  3  0  3  7  7  7  7  7  7  7  7  7  7  7  3  0  9  3
3  0  3  0  3  7  7  7  7  7  7  7  7  7  7  7  3  0  0  3
3  0  3  0  3  7  7  7  7  7  7  7  7  7  7  7  3  9  0  3
3  3  3  0  3  3  7  7  7  7  7  7  7  7  7  7  3  0  0  3
3  3  0  0  0  3  3  3  3  3  3  3  3  3  3  3  3  0  9  3
3 12  0  0  0 14  3  7  7  7  7  3  7  7  7  7  7  7  7  3
3 13  0  0  0 15  3  3  3  7  7  7  7  7  3  3  7  3  7  3
3  3  0  0  0  3  7  7  7  7  7  3  7  7  3  7  7  7  7  3
3  3  3 11  3  3  3  7  7  3  7  7  7  7  3  7  3  7  7  3
3  7  7  7  3  7  7  7  7  7  7  7  7  7  7  7  7  7  3  3
3  7  7  7  7  7  3  7  7  7  3  3  3  7  3  7  7  7  7  3
3  7  3  3  3  7  7  7  3  7  3  7  7  7  7  7  7  3  7  3
3  0  3  7  7  7  3  7  7  7  7  7  7  3  3  7  7  7  7  3
3 10  3  3  3  3  3  3  3  3  3  3  3  3  3  3  3  3  3  3
